42, 42, 42, 42, 42, 42, 42, 42, 42, 42, 42, 42, 42, 42, 42, 42, 42, 42, 42, 42, 42, 42, 42, 42, 42, 42, 42, 42, 42, 42, 42, 42, 42, 42,
219, 162, 162, 162, 162, 162, 162, 162, 162, 162, 162, 162, 162, 162, 162, 162, 162, 162, 162, 162, 162, 162, 162, 162, 162, 162, 162, 162, 162, 162, 162, 162, 162, 162,
239, 182, 182, 182, 182, 182, 182, 182, 182, 182, 182, 182, 182, 182, 182, 182, 182, 182, 182, 182, 182, 182, 182, 182, 182, 182, 182, 182, 182, 182, 182, 182, 182, 182,
259, 182, 182, 182, 182, 182, 182, 182, 219, 182, 182, 182, 182, 182, 182, 182, 182, 182, 182, 182, 182, 182, 219, 182, 182, 182, 182, 182, 182, 182, 182, 182, 182, 182,
182, 182, 182, 182, 182, 182, 182, 182, 239, 182, 182, 182, 182, 182, 182, 182, 182, 182, 182, 182, 182, 182, 239, 182, 182, 182, 182, 182, 182, 182, 182, 182, 182, 182,
182, 182, 182, 182, 182, 182, 182, 182, 259, 182, 179, 180, 182, 179, 180, 182, 179, 180, 182, 179, 180, 182, 259, 182, 182, 182, 182, 182, 182, 182, 182, 182, 182, 182,
182, 182, 182, 182, 182, 182, 182, 182, 182, 182, 199, 200, 182, 199, 200, 182, 199, 200, 182, 199, 200, 182, 182, 182, 182, 182, 182, 182, 182, 182, 182, 182, 182, 182,
182, 182, 182, 182, 182, 182, 182, 182, 182, 182, 182, 182, 182, 182, 182, 182, 182, 182, 182, 182, 182, 182, 202, 202, 202, 182, 182, 202, 182, 182, 182, 182, 182, 182,
182, 182, 182, 182, 182, 182, 167, 202, 168, 182, 202, 167, 202, 168, 202, 167, 202, 168, 182, 202, 182, 182, 126, 127, 128, 182, 182, 129, 182, 182, 182, 182, 182, 182,
182, 182, 182, 182, 182, 182, 183, 85, 181, 182, 124, 183, 85, 181, 124, 183, 85, 181, 182, 124, 182, 182, 182, 182, 182, 182, 182, 182, 182, 182, 202, 202, 182, 182,
182, 182, 182, 182, 167, 202, 196, 162, 188, 182, 182, 187, 162, 188, 182, 187, 162, 188, 182, 182, 182, 182, 182, 182, 182, 182, 182, 182, 182, 182, 121, 123, 182, 182,
182, 182, 182, 167, 203, 5, 181, 182, 182, 182, 182, 182, 182, 182, 182, 182, 182, 182, 182, 182, 182, 182, 182, 182, 182, 182, 182, 182, 182, 182, 182, 182, 182, 182,
202, 202, 202, 203, 1, 91, 201, 202, 202, 202, 202, 202, 202, 202, 202, 202, 202, 202, 202, 202, 202, 202, 202, 202, 202, 202, 202, 168, 182, 167, 202, 202, 202, 202,
2, 2, 2, 2, 28, 27, 2, 2, 2, 2, 2, 2, 2, 2, 2, 2, 2, 2, 2, 2, 2, 2, 2, 2, 2, 2, 3, 181, 182, 183, 1, 2, 2, 2,
22, 22, 22, 22, 22, 22, 22, 22, 22, 22, 22, 22, 22, 22, 22, 22, 22, 22, 22, 22, 22, 22, 22, 22, 22, 22, 23, 181, 182, 183, 21, 22, 22, 22,
22, 22, 22, 22, 7, 8, 22, 22, 7, 8, 22, 22, 7, 8, 22, 22, 7, 8, 22, 22, 7, 8, 22, 22, 22, 22, 23, 181, 182, 183, 21, 22, 7, 8,
22, 22, 22, 22, 27, 28, 22, 22, 27, 28, 22, 22, 27, 28, 22, 22, 27, 28, 22, 22, 27, 28, 22, 22, 22, 22, 23, 181, 182, 183, 21, 22, 27, 28,