42, 42, 42, 42, 42, 42, 42, 42, 42, 42, 42, 42, 42, 42, 42, 42, 42, 42, 42, 42, 42, 42, 42, 42, 42, 42, 42, 42, 42, 42, 42, 42, 42, 42,
219, 162, 162, 162, 162, 162, 162, 219, 162, 162, 162, 162, 162, 162, 162, 219, 162, 162, 162, 162, 162, 162, 162, 162, 162, 162, 162, 162, 162, 162, 162, 162, 219, 182,
239, 182, 179, 180, 182, 182, 182, 239, 182, 182, 182, 179, 180, 182, 182, 239, 182, 182, 182, 179, 180, 182, 182, 167, 202, 190, 202, 202, 202, 202, 168, 182, 239, 182,
259, 182, 199, 200, 182, 182, 182, 259, 182, 182, 182, 199, 200, 182, 182, 259, 182, 182, 182, 199, 200, 182, 182, 183, 5, 185, 81, 82, 82, 77, 181, 182, 259, 182,
182, 182, 126, 127, 128, 182, 182, 182, 182, 182, 182, 126, 127, 128, 182, 182, 182, 182, 182, 126, 127, 128, 182, 183, 25, 256, 228, 162, 163, 25, 181, 182, 182, 182,
182, 182, 182, 182, 182, 182, 182, 182, 182, 182, 182, 182, 182, 182, 182, 182, 182, 182, 182, 182, 182, 182, 182, 183, 96, 83, 181, 167, 203, 25, 181, 182, 182, 182,
182, 182, 182, 182, 182, 182, 182, 182, 182, 182, 182, 182, 182, 182, 182, 182, 182, 182, 167, 202, 202, 202, 202, 196, 162, 227, 248, 231, 81, 97, 181, 182, 182, 182,
182, 182, 202, 182, 202, 202, 182, 202, 182, 182, 182, 182, 167, 202, 168, 182, 202, 182, 183, 81, 82, 82, 83, 181, 182, 183, 5, 250, 162, 162, 188, 182, 182, 182,
182, 182, 85, 182, 121, 123, 182, 85, 182, 182, 182, 182, 183, 5, 181, 182, 85, 182, 187, 162, 162, 162, 162, 197, 202, 203, 25, 181, 182, 182, 182, 182, 182, 182,
182, 182, 182, 182, 182, 182, 182, 182, 182, 182, 182, 182, 183, 25, 201, 168, 182, 182, 182, 182, 182, 182, 182, 183, 81, 82, 74, 181, 182, 202, 202, 202, 182, 182,
182, 167, 202, 168, 182, 182, 167, 202, 168, 182, 182, 182, 183, 96, 83, 181, 167, 202, 168, 202, 167, 202, 168, 187, 162, 163, 45, 181, 182, 126, 127, 128, 182, 182,
182, 203, 5, 181, 182, 182, 183, 5, 181, 182, 182, 182, 247, 162, 162, 197, 203, 5, 181, 124, 183, 5, 201, 168, 182, 182, 162, 188, 182, 182, 182, 182, 182, 182,
203, 1, 91, 181, 182, 182, 203, 25, 181, 182, 182, 182, 85, 182, 182, 183, 81, 74, 181, 182, 183, 96, 83, 181, 182, 182, 182, 182, 182, 167, 202, 202, 202, 202,
2, 28, 23, 201, 202, 203, 1, 91, 201, 202, 202, 202, 233, 202, 202, 247, 243, 25, 181, 182, 187, 162, 162, 197, 202, 202, 202, 168, 182, 183, 1, 2, 2, 2,
22, 22, 27, 2, 2, 2, 28, 27, 2, 2, 2, 3, 185, 1, 2, 2, 2, 91, 181, 182, 182, 182, 182, 183, 1, 2, 3, 181, 182, 183, 21, 22, 22, 22,
22, 22, 22, 22, 22, 22, 22, 22, 22, 22, 22, 23, 185, 21, 22, 22, 22, 23, 181, 182, 182, 182, 182, 183, 21, 22, 23, 181, 182, 183, 21, 22, 22, 22,
22, 22, 22, 22, 22, 22, 22, 22, 22, 22, 22, 23, 185, 21, 22, 22, 22, 23, 181, 182, 182, 182, 182, 183, 21, 22, 23, 181, 182, 183, 21, 22