182, 182, 182, 182, 182, 182, 182, 182, 182, 182, 182, 182, 182, 182, 182, 182, 182, 182, 182, 182, 182, 182, 182, 182, 182, 182, 182, 182, 182, 182, 182, 182, 182, 182,
182, 182, 219, 182, 182, 179, 180, 182, 182, 182, 182, 179, 180, 182, 182, 182, 219, 182, 182, 182, 179, 180, 182, 182, 182, 182, 182, 179, 180, 182, 182, 219, 182, 182,
182, 182, 239, 182, 182, 199, 200, 182, 182, 182, 182, 199, 200, 182, 182, 182, 239, 182, 182, 182, 199, 200, 182, 182, 182, 182, 182, 199, 200, 182, 182, 239, 182, 182,
182, 182, 259, 182, 182, 126, 127, 128, 182, 182, 182, 126, 127, 128, 182, 182, 259, 182, 182, 182, 126, 127, 128, 182, 182, 182, 182, 126, 127, 128, 182, 259, 182, 182,
182, 182, 182, 182, 182, 182, 182, 182, 182, 182, 182, 182, 182, 182, 182, 182, 182, 182, 182, 182, 182, 182, 182, 182, 182, 182, 182, 182, 182, 182, 182, 182, 182, 182,
182, 182, 182, 182, 182, 182, 182, 182, 182, 182, 182, 182, 182, 182, 182, 182, 182, 182, 182, 182, 182, 182, 182, 182, 182, 182, 182, 182, 182, 182, 182, 182, 182, 182,
182, 182, 182, 182, 182, 182, 182, 182, 182, 182, 182, 167, 202, 202, 202, 202, 190, 202, 202, 202, 202, 168, 182, 182, 182, 182, 182, 182, 182, 182, 182, 182, 182, 182,
182, 182, 182, 182, 182, 182, 182, 167, 202, 168, 182, 183, 81, 82, 82, 83, 185, 81, 82, 82, 83, 181, 182, 167, 202, 168, 182, 182, 182, 182, 182, 182, 182, 182,
182, 182, 182, 182, 182, 182, 182, 183, 5, 181, 202, 187, 162, 162, 162, 162, 171, 162, 162, 162, 162, 188, 202, 183, 5, 181, 182, 182, 182, 182, 182, 182, 182, 182,
182, 182, 182, 182, 182, 167, 202, 231, 25, 181, 124, 182, 202, 182, 202, 202, 182, 202, 202, 182, 202, 182, 124, 183, 25, 230, 202, 168, 182, 182, 182, 182, 182, 182,
182, 182, 182, 182, 182, 183, 5, 185, 45, 181, 182, 182, 124, 182, 126, 128, 182, 126, 128, 182, 124, 182, 182, 183, 45, 185, 5, 181, 182, 182, 182, 182, 182, 182,
182, 182, 182, 167, 202, 231, 25, 256, 242, 170, 182, 182, 182, 182, 182, 182, 182, 182, 182, 182, 182, 182, 182, 191, 242, 257, 25, 230, 202, 168, 182, 182, 182, 182,
202, 202, 202, 231, 5, 185, 93, 82, 77, 230, 202, 190, 202, 202, 202, 202, 190, 202, 202, 202, 202, 190, 202, 231, 76, 82, 74, 185, 5, 230, 202, 202, 202, 202,
2, 2, 3, 185, 25, 185, 25, 165, 45, 185, 5, 185, 1, 2, 2, 3, 185, 1, 2, 2, 3, 185, 5, 185, 45, 165, 25, 185, 25, 185, 1, 2, 2, 2,
22, 22, 23, 185, 25, 185, 25, 181, 219, 183, 25, 185, 21, 22, 22, 23, 185, 21, 22, 22, 23, 185, 25, 181, 219, 183, 25, 185, 25, 185, 21, 22, 22, 22,
22, 22, 23, 185, 25, 185, 25, 181, 239, 183, 25, 185, 21, 22, 22, 23, 185, 21, 22, 22, 23, 185, 25, 181, 239, 183, 25, 185, 25, 185, 21, 22, 22, 22,
22, 22, 23, 185, 25, 185, 25, 181, 259, 183, 25, 185, 21, 22, 22, 23, 185, 21, 22, 22, 23, 185, 25, 181, 259, 183, 25, 185, 25, 185, 21, 22, 22, 22